NO ./path_to_the_north_texture

F 220,100,0

SO ./path_to_the_south_texture
WE ./path_to_the_west_texture
EA ./path_to_the_east_texture

C 225,30,0

        1111111111111111111111111                
        1000000000110000000000001
        1011000001110000000000001
        10010000000000000000000011111111111
1111111110110000011100000000000000000000001   
1000000000110000011101111111111111111111111    
11110111111111011100000010001     
110000001101010111000N0010001
100000001000000001100000010001
100000001000000001101010010001
1100000111010101111101111000111
11110111 1110101 101111010001
11111111 1111111 111111111111
