NO ./Textures/NO.xpm

F 220,100,0

SO ./Textures/SO.xpm
WE ./Textures/WE.xpm
EA ./Textures/EA.xpm


C 255,30,0

        1111111111111111111111111                
        1000000000110000000000001
        1011000001110000000000001
        10010000000000000000000011111111111
1111111110110000011100000000000000000000001   
1000000000110000011101111111111111111111111    
11110111111111011100000010001     
110000001101010111000N0010001
100000001000000000000000010001
100000001000000001101010010001
1100000111010101111101111000111
11110111 1110101 101111010001
11111111 1111111 111111111111
