NO ./Textures/NO.xpm

F 220,100,0

SO ./Textures/SO.xpm
WE ./Textures/WE.xpm
EA ./Textures/EA.xpm


C 255,30,0

1111111111111111111111111111
1000000000000000000000000001
100000000000000000000N000001
10000000010000000000000000
1000000000000000000000000001
1000000000000000000000000001
1111111111111111111111111111







