NO ./path_to_the_north_texture

F 220,100,0

SO ./path_to_the_south_texture
WE ./path_to_the_west_texture
EA ./path_to_the_east_texture



C 225,30,0


















        1111111111111111111111
        111111111111111111111111
        1000000000110000000000001
        1011000001110000000N00001








