NO ./Textures/NO.xpm

F 220,100,0

SO ./Textures/SO.xpm
WE ./Textures/WE.xpm
EA ./Textures/EA.xpm


C 255,30,0









        1111111111111111111111
        111111111111111111111111
        1000000000110000000000001
        1011000001110000000N00001













