NO ./Textures/NO.xpm
SO ./Textures/SO.xpm
WE ./Textures/WE.xpm
EA ./Textures/EA.xpm

F 220,100,0
C 255,30,0


111111111111111111111111111111111111111111111111111111111111111111111111111111
100000000000000000000000011111111111111111111111111111111111111111111111111111
100000000000000000000000011111111111111111111111111111111111111111111111111111
100000000000000000000000011111111111111111111111111111111111111111111111111111
100011111100000000000000011111111111111111111111111111111111111111111111111111
10000000000000000N000000011111111111111111111111111111111111111111111111111111
100000000000000000000000011111111111111111111111111111111111111111111111111111
111111111111111111111111111111111111111111111111111111111111111111111111111111
100000000000000000000000011111111111111111111111111111111111111111111111111111
111111111111111111111111111111111111111111111111111111111111111111111111111111
100000000000000000000000011111111111111111111111111111111111111111111111111111
111111111111111111111111111111111111111111111111111111111111111111111111111111
100000000000000000000000011111111111111111111111111111111111111111111111111111
111111111111111111111111111111111111111111111111111111111111111111111111111111
100000000000000000000000011111111111111111111111111111111111111111111111111111
100000000000000000000000011111111111111111111111111111111111111111111111111111
100000000000000000000000011111111111111111111111111111111111111111111111111111
100000000000000000000000011111111111111111111111111111111111111111111111111111
100000000000000000000000011111111111111111111111111111111111111111111111111111
100000000000000000000000011111111111111111111111111111111111111111111111111111
100000000000000000000000011111111111111111111111111111111111111111111111111111
100000000000000000000000011111111111111111111111111111111111111111111111111111


