NO ./Textures/NO.xpm
SO ./Textures/SO.xpm
WE ./Textures/WE.xpm
EA ./Textures/EA.xpm

F 220,100,0
C 255,30,0


1111
1011
10N1
1111

