NO ./Textures/NO.xpm
SO ./Textures/SO.xpm
WE ./Textures/WE.xpm
EA ./Textures/EA.xpm

F 220,100,0
C 255,30,0


1111111111111111111111111111
1000000000000000000000000111
1000000000000000000000000111
100000000000010000000000011111
100000000000000000000000011111
10000000000N00000000000001111
1000000000000000000000000111
111111111111111111111111111

