NO ./Textures/NO.xpm
SO ./Textures/SO.xpm
WE ./Textures/WE.xpm
EA ./Textures/EA.xpm

F 220,100,0
C 255,30,0


1111111111111111111111111111
100000000000000000000000011
100000000000000000000000011
100000000000000000000000011111
1000000000000000000000000111111111
1000000N000000000000000001
10000000000000000000000001


