NO ./Textures/NO.xpm

F 220,100,0

SO ./Textures/SO.xpm
WE ./Textures/WE.xpm
EA ./Textures/EA.xpm


C 255,30,0


1111111111111 1111111111111111111111111111111111111111
11 1111111111 111111111111111111111111111111111111111
11 1111111111 1111111111111111111111111111111111111111
11 1111111111 1111111111111111111111111111111111111111
11       1111 1111111111111111111111111111111111111111
11111111 1111 1111111111111111111111111111111111111111
11111111      1111111111111111111111111111111111N1111
1111111111111 1111111111111111111111111111111111111111