NO ./Textures/NO.xpm

F 220,100,0

SO ./Textures/SO.xpm
WE ./Textures/WE.xpm
EA ./Textures/EA.xpm


C 255,30,0


1111111111111 1111111111111111111111111111111111111111
11 1111111111 111111111             111111111111111111
11 1111111111 11111111111 11111111 1111111111111111111
11 1111111111 1111      1    111 1  1  11 11111
11       1111 111111111 1111 11111 111111  11111111111
11111111 1111 111111111 111111N111 111111 111111111111
11111111      111111111      1111  1111111 11111
1111111111111111111111111111 1111111111111111111111111