NO ./Textures/NO.xpm

F 20,20,20

SO ./Textures/SO.xpm
WE ./Textures/WE.xpm
EA ./Textures/EA.xpm


C 0,0,0


111111111111111111111
1E0000100000100000001
101010111011111110101
10111000000000X000101
101010111010111110111
101000001010000010001
111111101111111111101
100000001000000010001
101110111010111110111
100010100010101000001
101110111110101111101
100010101000000010001
101110101110111110101
100000100010000000101
101111101111111011101
100010000010000010001
101011111010101111101
101000001000100010101
101111111111111110101
1000000000100000000V1
111111111111111111111
