NO ./Textures/NO.xpm

F 220,100,0  
SO ./Textures/SO.xpm
WE ./Textures/WE.xpm
EA ./Textures/EA.xpm



C 255,30,0

                          1
                         101 
111111                11110011
1000N1                111000011
11100111111111111111111111011
100000000000000000000000000001
111111111111100111111111111111
         10000000001
         100000000001111111111111111111
         10000000000000000000000000000011
         111111100111111111000000000000001
  11111110011110011 100000000000001111111
  10000000000000001 100000000000111111
  10000000000000001 111111111111
  11111111000000001
  10000000000000001  111111111111111111111111
  1000000000000000011000000000000000000000001111
  10000000000000000000111000000000000000000000001
  100000000000000000000000000000000000000000000001
  11111111111111111111111111111111111111111111111