NO ./Textures/NO.xpm

F 220,100,0

SO ./Textures/SO.xpm
WE ./Textures/WE.xpm
EA ./Textures/EA.xpm


C 255,30,0




111111111111111111111111
100000000000000000000001
100000000001111100000001
10000000001     10000001
10000000001     10000S01
10000000001     10000001
100000000001111110000001
100000000000000000000001
111111111111111111111111
