NO ./Textures/NO.xpm

F 220,100,0

SO ./Textures/SO.xpm
WE ./Textures/WE.xpm
EA ./Textures/EA.xpm


C 255,30,0




111111111111111111111111
1000000000000X0000000001
100000000001111100000001
10000100001     11110001
10000000001     1000011
10000000001     10000001
100000000001111110111111
1000000000000W0000000001
111111111111111111111111
