NO ./Textures/NO.xpm

F 80,40,40

SO ./Textures/SO.xpm
WE ./Textures/WE.xpm
EA ./Textures/EA.xpm


C 0,0,0




1111111111V1111111111111
100VVV0000000000000000V1
100VXV000001111100000001
1VVVV100001     11110001
10000000001     1000011
10000000001     10000001
100000000001111110111111
1000000000000W0000000001
111111111111111111111111
