NO ./Textures/NO.xpm

F 220,100,0

SO ./Textures/SO.xpm
WE ./Textures/WE.xpm
EA ./Textures/EA.xpm


C 255,30,0




111111111111111111111111
100000000000000000000001
100001100001111100000001
10000100001     11110001
10000010001     1000011
10000010001     10000001
100000100001111110111111
1000001000000000000W0001
100000111111000000000111
100001      10000000000111
100001       10000000111
11101111111110000000101
10000000000000011110001
10000101010100010100011
10000000000000000111111
10000000000000000000001
10000000000000000000001
11111111111111111111111





